R 6400 100


NO                 texture/N.xpm

SO    texture/wall_2.xpm


F 100,200,0
WE texture/wall_3.xpm


EA          texture/wall_4.xpm


S texture/sprite_1.xpm



C 200,0,255




        111111111111111111111111
        1000000000110000000000001
        1011000001110000220000001
        1001000000000000000000001
111111111011000001110000E00000001
10000000001100000111011101011111
11110111111111011100000010001
1111011111111101 100010010001
1100000011010101 100000010001
10000000000000011100000010001
10000000000000000000000000001
11000001110101011111011110001
11110111 1110101 101111010001
11111111 1111111 111111111111